__________________________________
  _      _                        
  |  |  /                /       /
--|-/|-/-----__---)__---/----__-/-
  |/ |/    /   ) /   ) /   /   /  
__/__|____(___/_/_____/___(___/___
                                  
