 :::  ===  === :::====  :::====  :::      :::==== 
 :::  ===  === :::  === :::  === :::      :::  ===
 ===  ===  === ===  === =======  ===      ===  ===
  ===========  ===  === === ===  ===      ===  ===
   ==== ====    ======  ===  === ======== ======= 
                                                  
